000000000000000000000000033333333300030000000000000000000000000000000000000000000000000000000000000000000000000000000000
000000000000000000000000022222222200010000000000000000000000000000000000000000000000000000000000000000000000000000000000
000000000000000000000000000000000000010000000000000000000000000000000000000000000000000000000000000000000000000000000000
000000000000000000000000000000000000010000000000000000000000000000000000000000000000000000000000000000000000000000000000
000000000000000000000000000000000000010000003000000000000000000022222200000020000200002200000000000000000000003000000000
000000000000000000000000000000000000010000222222200000000020000000000000000000000000000000000000000000003000000000000000
000000000000000000000000000000000000000000000000000000000010000000000000000000000000000000000000000000002000000000000000
000000000000000000000300000000000000000000000000000222200000000000000000000000000000000000000000000000000000000000000000
000000000000000000022222200000000000000000000000000000000100000000000000000000000000000000000000000300000000000000000000
000000000000000000001111100000000000000000000000000000000000000000000000000000000000000000022222222200000000000000000000
000000000000000000000000000000000000000000000000000000200000000000000000000000000003000000000000000000000000000000000000
000000000000000000000000000000000000000000000000000000020000000000000000000000002222222220000000000000000000000000000000
000000000000000000000000000000000000000000000000000000010000000000000033000000000000111100000000000000000000000000000000
000000000000000000000000000000000000000000030000030000000300000000222222222220000000000000000000000000000000000000000000
000000000000000003000000000000000000002222222222222222222222222220000000000000000000000000000000000000222230000000000000
000000000000000022200000000000000000000000000000000000000000000000000000000000000000000003330000000000000000000000000000
000000000000000000030000000000222222000000000000000000000000000000000000000000000000000002222200000003222220000000000000
000000000000000002222200000000000000000000000000000000000000000000222000000000000000000000111100000000000000000000000000
000000000000000000000000000000000000222222000000000000000000000000000000000000000000000000000000000000000000000000000000
000000000003000000000000000022220000000000000002222200000000000000000000000030000000000000000000000000000000000000000000
000000000022200000000000000000000000000000000000000000000000000033000000000022200000000000030000000000022200000000000000
022222200000000033000000000000000000000000000000000000000000000222220000000001100000000000222200000000000000000000000000
000000000220000222222200000000022220000000000000000000000000000011000000000000000000000300000000000000000000000000000000
000000000000000000000000000000000000000000000222200000000000000000030000000000000000022222000000000000000000000000000000
000000022222000000000000000000000000000000000000000000222000000000222200000000000000000000000000000000000222200000000000
000000000000000000000000030000000000000000000000000000300000000000000000000000000000000000000002222200000000000000000000
220003003000000002200000022000000000000000000000002222222222200000000000000000000000000000000000000000000000000000000000
112222222222222221100000000000000000000000000000221111111111100000000000000000022220000000000000000000000000000000000000
111111111111111111100000000000000222222000022223111111111111100000030000000000011110000000000000022200000000030000000000
111111111111111111100000000000222111110000011301111111111111100000222200000000011113000000000030000000000000022000000000
111111111111111111100000300000011111100000000001111111130000000000000000000000000000000000022220000000000000000000000000
111111111111111111100000300000011111102222222211111111120002222000000000000000000000000000000000000000000000000000000000
111111111111111111122222322222211111121111111111111111112230000000000000000000000000000000000000000000000000000000000000